11111111111111111111
11................11
11................11
11................11
..................11
..................11
.p..1111111.......11
11................2.
11................2.
11.....b..........2.
11111111111111111111
