11111111111111111111
1.................11
1.................11
1.................11
1...................
1...................
1...................
..................11
..............11..11
.p........11..11..11
111111111111..11..11
