11111111111111111111
1.....t.....t.....11
1.................11
1.................11
1.................11
1.................11
1.................11
....................
....................
.p..................
11111111111111111111
