11111111111111111111
1...........t....t11
1.................11
1...........2....211
1.................2.
1.................2.
1.................2.
..................11
.........b...111..11
.p......111..111..11
111111..111..111..11
