bbbbbbbbbbbbbbbbbbbbbbbbbbbbbbbbbbbbbbbbbbbbbbbbbbbbbbbbbbbbbbbbbbbbbbbbbbbbbbbbbbbbbbbbbbbbbbbbbbbbbbbbbbbbbbbbbbbbbbbbbbbbbbbbbbbbbbbbbbbbbbbbbbbbbbbbbbbbbbbbbbbbbbbbbbbbbbbbbbbbbbbbbbbbbbbbbbbbbbbbbbbbbbbbbbbbbbbbbbbbbbbbbbbbbbbbbbbbbbbbbbbbbbbbbbbbbbbbbbbbbbbbbbbbbbbbbbgbbbbbbbbbbbbbbbbbb
..........................b......................b.................................b......................b............b...b.................b.b...........b........b.............b........b....................b.....b.....b........b...........b.......................b.....b.....................
..........b..........................b.....b.....b......b..........b..........................b.....b.....b............b...b....b.................b..........b..b............b....b..b..........bb.........b......b...b..........b........b....................b............b...b.b..................
.......b......b.....b...........b..................b........b......bb.........................b....b b....b........b...b.......b.............b..b........b...............b.........b.....b...........b......b......b......b........b......b......b......b........b...b.....b.........................
.......................b...................b.......b............b......b.....b...........b..................b..............b...........b........b......b...b........b.....b...........b....b........b................b..............b................b...............b........b...b..................
.........b.................b.........b..............b.....b.....................b...................b.......b...................b...........b.b......b.b......b...b......b.....b...........b............b.....b..........b.....b........b....b.b.b.......b........b..........b.......................
.............b........b...................b.........b..b......b...b...........b.....b.........b..............b.....b...b....b......b........b..................b...........................b..........b...............b.....................b..................b.........b....b.b....................
.........b......................b................b................b......b..........b.........b..............b.............b....................b.........b..b.......b......b..............b...............b.................b..............b..........b..............b........b.....................
...........b...............b..............b...b.....b..b....b.b.......b........b...................b.........b..b....b....b............b....b.....b.b......................b........................b...........b........b.........b..........b.........b.......b....b......b........................
....................b................b........b..b..b...b.........b..........b...........b................b..........b.....b.........................b.....................b............b...............b.............b.............b........b.b.....b.........b....b.b.........b....................
bbbbbbbbbbbbbbbbbbbbbbbbbbbbbbbbbbbbbbbbbbbbbbbbbbbbbbbbbbbbbbbbbbbbbbbbbbbbbbbbbbbbbbbbbbbbbbbbbbbbbbbbbbbbbbbbbbbbbbbbbbbbbbbbbbbbbbbbbbbbbbbbbbbbbbbbbbbbbbbbbbbbbbbbbbbbbbbbbbbbbbbbbbbbbbbbbbbbbbbbbbbbbbbbbbbbbbbbbbbbbbbbbbbbbbbbbbbbbbbbbbbbbbbbbbbbbbbbbbbbbbbbbbbbbbbbbbgbbbbbbbbbbbbbbbbbb
